x00000000000
111111111111
110010C00011
111C00010011
11001Y0C0X01
1110000010C1
110C00110011
1111001E1001
111000101011
11P000100011
111111111111
