x000000000000
1111111111111
100000C0000C1
10C0000000CC1
1000PX0000001
1111111111111
